1 1 1 1 1 1 1 1 1 1 1 1 1 1 1 1 1 1
1 6 6 6 6 6 6 6 6 6 6 6 6 6 6 6 6 1
1 6 6 6 6 6 6 6 6 6 6 6 6 6 6 6 6 1
1 6 6 6 6 6 6 6 6 6 6 6 6 6 6 6 6 1
1 6 6 6 6 6 6 6 6 6 6 6 6 6 6 6 6 1
1 6 6 6 6 6 6 6 6 6 6 6 6 6 6 6 6 1
1 6 6 6 6 6 6 6 6 6 6 6 6 6 6 6 6 1
1 1 1 1 6 1 1 1 1 6 6 6 6 6 6 6 6 1
1 6 6 6 6 6 6 6 1 6 6 6 6 6 6 6 6 1
1 6 6 6 6 6 6 6 1 6 6 6 6 6 6 6 6 1
1 6 6 6 6 6 6 6 1 3 3 3 3 6 6 6 6 1
1 6 6 6 6 6 6 6 1 3 3 3 3 6 6 6 6 1
1 6 6 6 6 6 6 6 1 3 3 3 3 6 6 6 6 1
1 1 1 1 1 1 1 1 1 1 1 1 1 1 1 1 1 1
